20,10,10,10,10,10,10,10,10,10,10,10,10,10,10,21
12,00,00,00,00,00,00,00,00,00,00,00,00,00,00,11
12,00,00,00,00,00,00,00,00,00,00,00,00,00,00,11
12,00,00,00,00,00,00,00,00,00,00,00,00,00,00,11
12,00,00,00,00,00,00,00,00,00,00,00,00,00,00,11
12,00,00,00,00,00,00,00,00,00,00,00,00,00,00,11
12,00,00,00,00,00,00,00,00,00,00,00,00,00,00,11
12,00,00,00,00,00,00,00,00,00,00,00,00,00,00,11
12,00,00,00,00,00,00,00,00,00,00,00,00,00,00,11
12,00,00,00,00,00,00,00,00,00,00,00,00,00,00,11
12,00,00,00,00,00,00,00,00,00,00,00,00,00,00,11
12,00,00,00,00,00,00,00,00,00,00,00,00,00,00,11
12,00,00,00,00,00,00,00,00,00,00,00,00,00,00,11
12,00,00,00,00,00,00,00,00,00,00,00,00,00,00,11
12,00,00,00,00,00,00,00,00,00,00,00,00,00,00,11
22,10,10,10,10,10,10,10,10,10,10,10,10,10,10,23